# num rows, num cols
41, 41
# optimal path cost
412
# grid data
XXXXXXXXXXXXXXXXXXXXXXXXXXXXXXXXXXXXXXXXX
XP    X         X         X X           X
X X X X XXXXX XXX XXXXX X X X XXX XXXXX X
X X X   X   X X   X     X   X   X   X   X
X X XXXXX X X X XXX XXX XXXXXXX XXX XXXXX
X X     X X X X X X X   X   X   X   X   X
X XXXXX X X XXX X X XXXXX X X XXX XXX X X
X     X   X X     X X     X   X   X   X X
XXXXXXX XXX X XXXXX X XXXXXXX X X X XXX X
X     X X   X X     X X     X X X X   X X
X XXX XXX XXX X XXXXX X XXX XXX XXXXXXX X
X X       X   X     X X X       X     X X
X X XXXXX X XXXXXXX X X XXXXXXX X XXX X X
X X X   X X X   X   X X X   X   X X   X X
X X X X X X X XXX XXX X X X XXX X X XXX X
X X X X X X X   X     X   X   X X X     X
X X X X XXX X X XXXXXXX XXXXX X X XXXXXXX
X X X X     X X   X   X   X   X X X   X X
X XXX XXXXXXXXX XXX X X XXX XXX X X X X X
X X   X         X   X X X   X X X X X   X
X X XXX XXXXXXX X XXX XXX XXX X X X XXX X
X X     X       X X X     X X   X X   X X
X X XXXXXXXXXXX X X XXXXXXX X XXX XXX X X
X   X         X X X         X X X     X X
X XXX XXXXXXX XXX XXXXXXX X X X XXXXXXX X
X   X       X   X X     X X     X X     X
XXX XXXXXXX XXX X X XXX XXXXXXX X X XXXXX
X X     X   X X   X   X X     X   X     X
X XXX XXX XXX X XXXXX X X XXX XXX XXXXX X
X   X X   X     X     X   X   X       X X
X X X X XXX XXXXX XXXXXXXXX XXX XXXXXXX X
X X   X X X X   X       X   X     X   X X
XXXXXXX X X X XXXXXXXXX X XXX XXXXX X X X
X       X   X     X X   X X     X   X X X
X XXXXXXX XXXXX X X X XXX XXXXX X XXX X X
X X     X       X   X X X   X   X X   X X
X X XXX XXX XXXXXXXXX X XXX XXXXX X X X X
X   X X   X X       X X   X       X X X X
X XXX XXX XXX XXXXX X XXX XXXXXXXXX XXX X
X       X         X               X    EX
XXXXXXXXXXXXXXXXXXXXXXXXXXXXXXXXXXXXXXXXX