# num rows, num cols
13, 18
# optimal path cost
32
# grid data
XXXXXXXXXXXXXXXXXX
X    X P  X      X
X XX XX X   XXXX X
X  X    XXXX   X X
XX XXXXXX  X X   X
X  X     X  XXXX X
X XX X XXX XX  X X
X    X X    XX X X
XXX X  XXX  XX X X
X X XX         X X
X X X X X X XXXX X
X   X   XEX      X
XXXXXXXXXXXXXXXXXX